home	ngôi nhà
bottle	chai, lọ
glasses	kính
gas stove	bếp gas
heave	phập phồng
here	ở đây
name	tên
mom	mẹ
dad	cha
parent	cha mẹ
book	sách
film	phim
chicken	con gà
bedroom	phòng ngủ
hotel	khách sạn
game show	chương trình truyền hình
game	điện tử
ball	trái bóng
sex	giới tính
house	ngôi nhà
hello	xin chào
low	thấp
high	cao
chief	đầu bếp
illustrate	làm sáng tỏ
illegal	phạm luật
instruction	hướng dẫn
comment	bình luận
company	công ty
math	toán học
morning	buổi sáng
afternoon	buổi chiều
evening	buổi tối
special	đặc biệt
eliminate	loại bỏ
delete	xóa
insert	thêm vào
chinese	Trung Quốc
lunch	buổi trưa
health	sức khỏe
lost	mất
laugh	cười
project	dự án
quantity	số lượng
translate	phiên dịch
transport	phương tiện giao thông
transform	chuyển đổi
hell	địa ngục
head	đầu
fill	làm đầy
double	gấp đôi
full	đầy
push	đẩy
file	tập tin
document	tài liệu
police	cảnh sát
guard	vệ sĩ
bag	túi
bay	vịnh
clock	đồng hồ
city	thành phố
country	đất nước
province	tỉnh
provide	cung cấp
product	sản xuất
production	sản phẩm
professor	giáo sư
profession	chuyên nghiệp
profile	hồ sơ
process	quá trình
probably	có khả năng
property	tài sản
proof	bằng chứng
pronounce	phát âm
prohibit	nghiêm cấm
problem	vấn đề
soul	tâm hồn
scan	quét
union	vùng miền
ultimate	đột phá
girl	cô gái
boy	chàng trai
beat	nhịp điệu
world	thế giới
laptop	máy tính xách tay
source	nguồn
garden	khu vườn
tea	trà
elephant	con voi
estimate	xấp xỉ
expect	kỳ vọng
develope	phát triển
deep	sâu
lamp	đèn
sing	hát
shout	gào thét
gun	súng
allow	cho phép
all	tất cả
ant	con kiến
author	tác giả
ancestor	tổ tiên
array	dãy, hàng
application	ứng dụng
cow	con bò
hi	chào
after	sau khi
address	địa chỉ
again	lại, lần nữa
aim	nhắm
air	không khí
pig	con lợn
pillot	phi công
port	cảng
